40 30
1856 1664
3 3 3 3 3 3 3 3 3 3 3 3 3 3 3 3 3 3 3 3 3 3 3 3 3 3 3 3 3 3 3 3 3 3 3 3 3 3 3 3
3 1 1 1 1 1 1 1 1 1 1 1 1 1 1 1 1 0 1 1 1 1 1 1 1 1 1 1 1 1 1 1 0 0 1 1 1 1 1 3
3 1 1 1 1 1 1 1 1 1 1 1 1 1 1 1 1 0 1 1 1 1 1 1 1 1 1 1 1 1 1 1 0 0 1 1 1 1 1 3
3 1 1 1 1 1 0 5 1 1 1 1 1 1 1 1 1 0 1 1 1 1 1 1 1 1 1 1 1 1 0 0 0 0 1 1 1 1 1 3
3 5 1 1 5 5 0 1 1 1 1 1 1 1 1 1 0 0 0 0 1 1 1 1 1 1 1 1 1 0 0 0 5 1 1 1 1 1 0 3
3 5 1 1 5 0 0 1 1 0 5 5 5 5 5 0 0 0 0 0 0 1 1 1 1 1 1 0 1 0 0 0 5 1 1 1 0 5 0 3
3 5 1 1 5 0 0 1 0 0 0 0 0 0 0 0 0 0 0 0 0 0 1 1 1 1 1 0 1 0 0 0 5 1 1 0 0 0 0 3
3 5 1 1 5 0 0 1 1 1 1 1 1 1 1 1 0 0 0 0 0 0 0 1 1 1 1 0 1 0 0 0 0 0 1 1 1 1 1 3
3 5 1 5 5 0 0 1 1 1 1 1 1 1 1 1 1 1 1 1 1 1 1 1 1 1 0 0 1 1 1 1 1 0 1 1 1 1 1 3
3 5 1 1 5 0 0 0 1 1 1 1 1 1 1 1 1 1 1 1 1 1 1 1 1 1 0 0 1 1 1 1 1 0 0 1 1 1 1 3
3 5 1 1 5 0 0 0 1 0 1 1 1 1 1 1 1 1 1 1 1 1 0 1 1 0 0 0 1 1 1 1 1 0 0 1 1 1 1 3
3 5 1 1 5 0 0 0 1 0 0 1 1 1 1 0 1 1 1 1 0 1 1 1 1 1 1 1 1 1 1 1 1 0 0 0 1 1 1 3
3 5 1 1 5 0 0 0 5 0 0 5 5 5 5 0 5 5 5 5 0 1 1 1 1 1 1 1 1 1 1 1 1 1 1 1 0 1 1 3
3 5 1 1 5 0 1 1 1 1 1 1 1 1 1 1 1 1 1 1 0 0 1 1 1 1 1 1 1 1 1 1 1 1 1 1 1 1 0 3
3 5 5 1 5 0 1 1 1 1 1 1 1 1 1 1 1 1 1 1 0 0 0 1 1 1 1 1 0 1 1 1 1 1 1 1 1 1 0 3
3 5 1 1 5 0 0 1 1 1 1 1 1 1 1 1 1 1 1 1 1 0 0 5 5 5 5 5 0 0 0 1 1 1 1 0 1 0 0 3
3 5 1 1 5 0 0 0 1 1 1 1 1 1 1 1 1 1 1 1 1 1 1 1 1 0 0 0 0 0 0 1 1 1 0 0 1 0 0 3
3 5 1 1 5 0 0 0 0 5 0 5 0 5 0 5 0 0 0 1 1 1 1 1 1 2 4 4 0 0 1 1 1 1 0 0 1 0 0 3
3 5 1 1 5 0 0 0 0 0 0 0 0 0 0 0 0 0 1 1 1 1 1 1 1 2 4 4 0 1 1 1 1 0 0 0 1 0 0 3
3 5 1 1 5 0 0 0 5 5 5 5 5 5 5 5 5 0 1 1 1 0 0 0 0 0 0 0 0 1 1 1 1 0 0 0 1 0 0 3
3 5 1 5 5 0 1 1 1 1 1 1 1 1 1 1 1 1 1 1 1 1 0 0 0 0 0 1 1 1 1 1 0 0 0 0 1 0 0 3
3 5 1 1 5 0 1 1 1 1 1 1 1 1 1 1 1 1 1 0 1 1 0 1 1 1 1 1 1 1 1 1 0 0 0 0 1 0 0 3
3 5 1 1 5 0 1 1 1 1 1 1 1 1 1 1 1 1 1 1 0 1 0 1 1 1 1 1 1 1 1 0 0 0 0 0 1 0 0 3
3 5 1 1 5 0 1 1 0 1 1 0 1 1 0 1 1 0 1 1 1 1 0 1 1 1 1 1 0 5 0 0 0 1 1 1 1 1 1 3
3 5 1 1 5 0 0 1 1 1 1 1 1 1 1 1 1 1 1 1 1 0 0 0 1 1 0 1 0 0 0 0 0 1 1 1 1 1 1 3
3 0 1 1 0 0 0 5 5 5 5 5 5 5 5 5 5 5 5 1 1 1 0 0 1 1 1 1 0 0 0 0 0 1 1 1 1 1 1 3
3 0 1 1 0 0 0 0 0 0 0 0 0 0 0 0 0 0 0 0 1 1 0 0 0 1 1 1 1 1 0 0 0 1 1 1 1 1 1 3
3 0 1 1 1 1 1 1 1 1 1 1 1 1 1 1 1 1 1 1 1 0 0 0 0 0 1 1 1 1 0 0 0 1 1 1 1 1 1 3
3 0 1 1 1 1 1 1 1 1 1 1 1 1 1 1 1 1 1 1 1 0 0 0 0 0 0 0 0 0 0 0 0 5 5 5 5 5 5 3
3 3 3 3 3 3 3 3 3 3 3 3 3 3 3 3 3 3 3 3 3 3 3 3 3 3 3 3 3 3 3 3 3 3 3 3 3 3 3 3
